TILEMAP
20 20
16 32
images/sprites.png
32 66
2026 2031 2031 2031 2031 2031 2031 2031 2031 2031 2031 2031 2031 2031 2031 2031 2031 2031 2031 2029 
2031 0 0 0 0 0 0 0 0 0 0 0 0 0 0 0 0 0 0 2031 
2031 0 0 0 0 0 0 0 0 0 0 0 0 0 0 0 0 0 0 2031 
2031 0 0 0 0 0 0 0 0 0 0 0 0 0 0 0 0 0 0 2031 
2031 0 0 0 0 0 0 0 0 0 0 0 0 0 0 0 0 0 0 2031 
2031 0 0 0 0 0 0 0 0 0 0 0 0 0 0 0 0 0 0 2031 
2031 0 0 0 0 0 0 0 0 0 0 0 0 0 0 0 0 0 0 2031 
2031 0 0 0 1890 1894 1894 1894 1894 1894 1894 1894 1894 1894 1894 1893 0 0 0 2031 
2031 0 0 0 724 724 724 724 724 752 724 724 724 724 724 724 0 0 0 2031 
2031 0 0 0 724 724 724 724 724 752 724 724 724 679 724 724 0 0 0 2031 
2031 0 0 0 724 724 724 724 724 752 724 724 724 724 724 724 0 0 0 2031 
2031 0 0 0 1890 1894 1894 1894 1894 1894 1894 1894 1894 1894 1894 1893 0 0 0 2031 
2031 0 0 0 0 0 0 0 0 0 0 0 0 0 0 0 0 0 0 2031 
2031 0 0 0 0 0 0 0 0 0 0 0 0 0 0 0 0 0 0 2031 
2031 0 0 0 0 0 0 0 0 0 0 0 0 0 0 0 0 0 0 2031 
2031 0 0 0 0 0 0 0 0 0 0 0 0 0 0 0 0 0 0 2031 
2031 0 0 0 0 0 0 0 0 0 0 0 0 0 0 0 0 0 0 2031 
2031 0 0 0 0 0 0 0 0 0 0 0 0 0 0 0 0 0 0 2031 
2031 0 0 0 0 0 0 0 0 0 0 0 0 0 0 0 0 0 0 2031 
2082 2031 2031 2031 2031 2031 2031 2031 2031 2031 2031 2031 2031 2031 2031 2031 2031 2031 2031 2083