TILEMAP
20 20
16 32
images/sprites.png
32 66
2026 2031 2031 2031 2031 2031 2031 2031 2031 2031 2031 2031 2031 2031 2031 2031 2031 2031 2031 2029 
2031 0 0 0 0 0 0 0 0 0 0 0 0 0 0 0 0 0 0 2031 
2031 0 0 0 0 0 0 0 0 0 0 0 0 0 0 0 0 0 0 2031 
2031 0 0 0 0 0 0 0 0 0 0 0 0 0 0 0 0 0 0 2031 
2031 0 0 0 0 0 0 0 1898 1894 1894 1894 1894 1894 1894 1901 0 0 0 2031 
2031 0 0 0 0 0 0 0 1899 0 0 0 0 0 0 1899 0 0 0 2031 
2031 0 0 0 0 0 0 0 1899 0 0 0 0 0 0 1899 0 0 0 2031 
2031 0 0 0 1898 1894 1894 1894 1895 0 0 0 0 0 0 1899 0 0 0 2031 
2031 0 0 0 1899 724 724 724 724 0 0 0 0 0 0 1899 0 0 0 2031 
2031 0 0 0 1899 724 0 724 724 0 679 0 0 0 0 1899 0 0 0 2031 
2031 0 0 0 1899 724 724 724 724 0 0 0 0 0 0 1899 0 0 0 2031 
2031 0 0 0 1892 1894 1894 1894 1894 1894 1894 1894 1894 1894 1894 1895 0 0 0 2031 
2031 0 0 0 0 0 0 0 0 0 0 0 0 0 0 0 0 0 0 2031 
2031 0 0 0 0 0 0 0 0 0 0 0 0 0 0 0 0 0 0 2031 
2031 0 0 0 0 0 0 0 0 0 0 0 0 0 0 0 0 0 0 2031 
2031 0 0 0 0 0 0 0 0 0 0 0 0 0 0 0 0 0 0 2031 
2031 0 0 0 0 0 0 0 0 0 0 0 0 0 0 0 0 0 0 2031 
2031 0 0 0 0 0 0 0 0 0 0 0 0 0 0 0 0 0 0 2031 
2031 0 0 0 0 0 0 0 0 0 0 0 0 0 0 0 0 0 0 2031 
2081 2031 2031 2031 2031 2031 2031 2031 2031 2031 2031 2031 2031 2031 2031 2031 2031 2031 2031 2083