TILEMAP
20 20
16 32
images/sprites.png
32 66
2026 2031 2031 2031 2031 2031 2031 2031 2031 2031 2031 2031 2031 2031 2031 2031 2031 2031 2031 2029 
2031 0 0 0 0 0 0 0 0 0 0 0 0 0 0 0 0 0 0 2031 
2031 0 0 0 0 0 0 0 0 0 0 0 0 0 0 0 0 0 0 2031 
2031 0 0 0 0 0 0 0 0 0 0 0 0 0 0 0 0 0 0 2031 
2031 0 0 0 0 0 0 0 0 0 0 1898 1894 1894 1894 1901 0 0 0 2031 
2031 0 0 0 0 0 0 0 0 0 0 1899 724 724 724 1899 0 0 0 2031 
2031 0 0 0 0 0 0 0 0 0 0 1899 724 679 724 1899 0 0 0 2031 
2031 0 0 0 0 0 0 0 0 0 0 1899 724 724 724 1899 0 0 0 2031 
2031 0 0 0 0 1834 1894 1894 1894 1894 1894 1896 1894 1894 1894 1871 0 0 0 2031 
2031 0 0 0 0 1899 0 0 0 0 0 0 0 0 0 1899 0 0 0 2031 
2031 0 0 0 0 1899 0 0 0 0 0 0 0 0 0 1899 0 0 0 2031 
2031 0 0 0 0 1899 0 0 0 0 0 0 0 0 0 1899 0 0 0 2031 
2031 0 0 0 0 1899 0 0 0 0 0 0 0 0 0 1899 0 0 0 2031 
2031 0 0 0 0 1899 0 0 0 0 0 0 0 0 0 1899 0 0 0 2031 
2031 0 0 0 0 1899 0 0 0 0 0 0 0 0 0 1899 0 0 0 2031 
2031 0 0 0 0 1899 0 0 0 0 0 0 0 0 0 1899 0 0 0 2031 
2031 0 0 0 0 1892 1894 1894 1894 1894 1894 1894 1894 1894 1894 1895 0 0 0 2031 
2031 0 0 0 0 0 0 0 0 0 0 0 0 0 0 0 0 0 0 2031 
2031 0 0 0 0 0 0 0 0 0 0 0 0 0 0 0 0 0 0 2031 
2082 2031 2031 2031 2031 2031 2031 2031 2031 2031 2031 2031 2031 2031 2031 2031 2031 2031 2031 2087