TILEMAP
20 20
16 32
images/sprites.png
32 66
2026 2031 2031 2031 2031 2031 2031 2031 2031 2031 2031 2031 2031 2031 2031 2031 2031 2031 2031 2093 
2031 0 0 1897 0 0 0 0 0 0 0 0 0 0 0 0 0 0 0 2031 
2031 0 0 1899 0 0 0 0 0 0 0 0 0 0 0 0 0 0 0 2031 
2031 0 0 1899 0 0 1898 1894 1894 1894 1894 1894 1894 1901 0 0 0 0 0 2031 
2031 1890 1894 1895 0 0 1899 724 724 724 724 724 724 1899 0 0 0 0 0 2031 
2031 0 0 0 0 0 1899 724 724 0 0 0 724 1899 0 0 0 0 0 2031 
2031 0 0 0 0 0 1899 724 724 724 724 724 724 1899 0 0 0 0 0 2031 
2031 0 0 0 0 0 1899 724 724 724 0 0 724 1899 0 0 0 0 0 2031 
2031 0 0 0 0 0 1899 724 724 724 724 724 724 1899 0 0 0 0 0 2031 
2031 0 0 1898 1894 1894 1896 1893 1537 1537 1537 1537 1890 1896 1894 1894 1901 0 0 2031 
2031 0 0 1899 0 0 0 0 0 0 0 0 0 0 0 0 1899 0 0 2031 
2031 0 0 1899 0 0 0 0 0 0 0 0 0 0 0 0 1899 0 0 2031 
2031 0 0 1899 0 0 0 0 0 0 0 0 0 0 0 0 1899 0 0 2031 
2031 0 0 1899 1537 1537 1537 0 0 0 0 0 0 0 0 0 1899 0 0 2031 
2031 0 0 1899 1537 1537 1537 0 0 0 0 0 0 0 0 0 1899 0 0 2031 
2031 0 0 1899 679 1537 1537 0 0 0 0 0 0 0 0 0 1899 0 0 2031 
2031 0 0 1892 1894 1894 1894 1894 1894 1894 1894 1894 1894 1894 1894 1894 1895 0 0 2031 
2031 0 0 0 0 0 0 0 0 0 0 0 0 0 0 0 0 0 0 2031 
2031 0 0 0 0 0 0 0 0 0 0 0 0 0 0 0 0 0 0 2031 
2082 2031 2031 2031 2031 2031 2031 2031 2031 2031 2031 2031 2031 2031 2031 2031 2031 2031 2031 2087