TILEMAP
20 20
16 32
images/sprites.png
32 66
2026 2031 2031 2031 2031 2031 2031 2031 2031 2031 2031 2031 2031 2031 2031 2031 2031 2031 2031 2029 
2031 0 0 0 0 0 0 0 0 0 0 0 0 0 0 0 0 0 0 2031 
2031 0 0 0 0 0 0 0 0 0 0 0 0 0 0 0 752 0 0 2031 
2031 0 0 0 752 0 0 0 752 0 0 0 0 0 0 0 0 0 0 2031 
2031 0 0 0 0 0 0 0 0 0 752 0 0 0 0 0 0 0 0 2031 
2031 0 0 0 0 0 0 0 0 0 0 0 0 0 0 0 0 0 0 2031 
2031 0 1834 1894 1894 1894 1837 0 0 0 0 1601 1601 1601 1601 1601 0 0 0 2031 
2031 0 1899 724 724 724 1891 0 0 0 0 1601 0 0 0 1601 0 0 0 2031 
2031 0 1899 724 0 724 752 0 0 0 0 1601 0 679 0 1601 0 0 0 2031 
2031 0 1899 724 724 724 1897 0 0 0 0 1601 0 0 0 1601 0 0 0 2031 
2031 0 1892 1894 1894 1894 1895 0 0 0 0 1601 1601 1601 1601 1601 0 0 0 2031 
2031 0 0 0 0 0 0 0 0 0 0 0 0 0 0 0 0 0 0 2031 
2031 0 0 0 0 0 0 0 0 0 0 0 0 0 0 0 0 0 0 2031 
2031 0 1889 0 0 0 1889 0 0 0 0 0 0 0 0 752 0 0 0 2031 
2031 0 0 0 0 0 0 0 0 0 0 0 0 0 0 0 0 0 0 2031 
2031 0 0 0 0 0 0 0 0 0 0 0 0 0 0 0 0 0 0 2031 
2031 0 0 0 0 0 0 0 0 0 0 0 0 0 0 0 0 0 0 2031 
2031 0 0 0 0 0 0 0 0 0 0 0 0 0 0 0 0 0 0 2031 
2031 0 0 0 0 0 0 0 0 0 0 0 0 0 0 0 0 0 0 2031 
2081 2031 2031 2031 2031 2031 2031 2031 2031 2031 2031 2031 2031 2031 2031 2031 2031 2031 2031 2087