TILEMAP
20 20 
24 40 
images/blocks.png 
2 2 
11111111111111111111
1                  1
11111              1
1                  1
1                  1
111111111111111    1
1                  1
1                  1
1                  1
111  111111111111111
1                  1
1                  1
1                  1
1111111111111 111111
1                  1
1       111111111111
1                  1
1                4 1
1                  1
11111111111111111111
